5,0,3,3,3
0,0,2,2,3
0,0,2,2,3
1,2,6,5,1
1,0,2,1,5
