0,1,1,0,1
0,1,0,1,0
6,2,2,2,6
0,5,6,1,1
1,0,2,1,0
